############################################
#  *  *        *  *  *  *  *        *  *   #
# #################### ################### #
#        *  *  *                           #
# #################### ################### #
#  *  *  *  *                 *  *  *  *   #
# #################### ################### #
#        *  *  *  *                        #
############################################
