############################################
#  *  *  *  *  *  *  *  *  *  *  *  *  *   #
# #################### ################### #
#                                          #
# #################### ################### #
#  *  *  *  *  *  *  *  *  *  *  *  *  *   #
# #################### ################### #
#                                          #
############################################
